2000, 2000, 100, 1, 20, 5, 0, 0, 0
2000, 2000, 100, 20, 30, 5, 5, 0, 0
3000, 3000, 200, 35, 50, 10, 0, 0, 0
3000, 3000, 250, 50, 20, 0, 14, 1, 0
3000, 3000, 275, 65, 50, 5, 0, 5, 0
4000, 4000, 300, 80, 60, 0, 0, 0, 0
4000, 4000, 20, 95, 65, 0, 0, 0, 0
5000, 5000, 50, 115, 100, 0, 0, 0, 0
2000, 2000, 100, 0, 30, 0, 0, 0, 0
3000, 3000, 100, 0, 30, 0, 0, 0, 0