5000, 5000, 100, 1, 20, 0, 1, 0, 0, 1
5000, 5000, 100, 20, 30, 5, 5, 0, 0, 2
5000, 5000, 200, 35, 50, 10, 0, 0, 0, 1
5000, 5000, 250, 50, 20, 0, 14, 1, 0, 1
5000, 5000, 275, 65, 50, 5, 0, 5, 0, 1,
5000, 5000, 300, 80, 60, 0, 0, 0, 0, 1
5000, 5000, 20, 95, 65, 0, 0, 0, 0, 1
5000, 5000, 50, 115, 100, 0, 0, 0, 0, 1
5000, 5000, 100, 0, 30, 0, 0, 0, 0, 1
5000, 5000, 100, 0, 30, 0, 0, 0, 0, 1